21 13
1 0 8  1 0 8  1 0 8  1 0 8  1 0 8  1 0 8  1 0 8  1 0 8  1 0 8  1 0 8  1 0 8  1 0 8  1 0 8  
1 0 8  2 0 8  3 0 1  2 0 8  2 0 8  3 0 8  2 0 8  2 0 8  2 0 8  2 0 8  2 0 8  2 0 8  1 0 8  
1 0 8  2 0 8  1 0 8  3 0 8  1 0 8  3 0 8  1 0 8  2 0 8  1 0 8  2 0 8  1 0 8  2 0 8  1 0 8  
1 0 8  2 0 8  3 0 8  3 0 8  2 0 8  2 0 8  2 0 8  2 0 8  2 0 8  2 0 8  2 0 8  2 0 8  1 0 8  
1 0 8  2 0 8  1 0 8  2 0 8  1 0 8  2 0 8  1 0 8  2 0 8  1 0 8  2 0 8  1 0 8  2 0 8  1 0 8  
1 0 8  3 0 8  3 0 8  2 0 8  2 0 8  2 0 8  2 0 8  2 0 8  2 0 8  2 0 8  3 0 0  2 0 8  1 0 8  
1 0 8  2 0 8  1 0 8  2 0 8  1 0 8  2 0 8  1 0 8  2 0 8  1 0 8  3 0 8  1 0 8  2 0 8  1 0 8  
1 0 8  2 0 8  3 0 8  2 0 8  2 0 8  2 0 8  2 0 8  2 0 8  2 0 8  3 0 8  2 0 8  2 0 8  1 0 8  
1 0 8  2 0 8  1 0 8  2 0 8  1 0 8  3 0 8  1 0 8  3 0 8  1 0 8  2 0 8  1 0 8  2 0 8  1 0 8  
1 0 8  2 0 8  3 0 8  2 0 8  2 0 8  2 0 8  2 0 8  2 0 8  2 0 8  2 0 8  2 0 8  2 0 8  1 0 8  
1 0 8  2 0 8  1 0 8  2 0 8  1 0 8  3 0 8  1 0 8  2 0 8  1 0 8  3 0 8  1 0 8  2 0 8  1 0 8  
1 0 8  2 0 8  2 0 8  2 0 8  3 0 8  2 0 8  2 0 8  2 0 8  2 0 8  2 0 8  3 0 8  2 0 8  1 0 8  
1 0 8  2 0 8  1 0 8  2 0 8  1 0 8  3 0 8  1 0 8  2 0 8  1 0 8  3 0 8  1 0 8  2 0 8  1 0 8  
1 0 8  2 0 8  2 0 8  2 0 8  3 0 8  2 0 8  2 0 8  2 0 8  2 0 8  2 0 8  3 1 8  2 0 8  1 0 8  
1 0 8  2 0 8  1 0 8  3 0 8  1 0 8  3 0 8  1 0 8  2 0 8  1 0 8  2 0 8  1 0 8  2 0 8  1 0 8  
1 0 8  2 0 8  3 0 1  2 0 8  2 0 8  3 0 8  2 0 8  2 0 8  2 0 8  2 0 8  2 0 8  2 0 8  1 0 8 
1 0 8  2 0 8  1 0 8  3 0 8  1 0 8  3 0 8  1 0 8  2 0 8  1 0 8  2 0 8  1 0 8  2 0 8  1 0 8  
1 0 8  2 0 8  3 0 8  3 0 8  2 0 8  2 0 8  2 0 8  2 0 8  2 0 8  2 0 8  2 0 8  2 0 8  1 0 8  
1 0 8  2 0 8  1 0 8  2 0 8  1 0 8  2 0 8  1 0 8  2 0 8  1 0 8  2 0 8  1 0 8  2 0 8  1 0 8  
1 0 8  2 0 8  3 0 8  2 0 8  2 0 8  2 0 8  2 0 8  2 0 8  2 0 8  2 0 8  2 0 8  2 0 8  1 0 8  
1 0 8  1 0 8  1 0 8  1 0 8  1 0 8  1 0 8  1 0 8  1 0 8  1 0 8  1 0 8  1 0 8  1 0 8  1 0 8  